- - - - - - - - - - - - G G G G 
- - - - - - - - - - - - - - G G 
- - - - - - - - - K - - - - - G 
- - - - - - - - - G - G - - - G 
- - - - - - - - - - - - - G - G 
- - - - - - - G - - - - - - - G 
- - - - - - G - - - - - G G G - 
- - - - M G - - - - - - - - G - 
- - - M G - - - - - G G G G - - 
- - M G - - - - - - - - - - - - 
- - G - - - - - - - - - - - - - 
G G G - - - - - - - - - - G G G 