- - - - - - - - - - - - - - - - 
- - - - - - - - - - - - - - - - 
- - - - - - - - - - - - - - - - 
- - - - - - - - - - - - - - - - 
- - - - - - - - - - - - - - - - 
- - - - - - - - - K - - - - - - 
- - - - - - - - - G - - - - G - 
- - - - - - - - - - - - G G - - 
- - - - - - - - - - - G G - - - 
- - - - - - Q - - - - - - - - - 
- - - M M G - - - - - - - - - - 
G G G G G G G G G G G G G G G G 