- - - - - - - - - - - - - - - G 
- - - - - - - - - - - - - - G G 
- - - - - G G - - - - - K G G G 
- G G - - - - - - - - - G G G G 
- - - - - - - - - G G G G G G G 
- - - - - - - - - - G G G G G G 
G - - - G G - - - - - G G G G G 
- G - - - - - - - - - G G G G G 
- - - G - - - G - - - - G G G G 
- - - - - - - - - Q Q Q - - - - 
- - - - - - - - - - - - - - - - 
G G G G G G G G G G G G G G G G 