- - - - - - - - - - - - - - - - 
- - - - - - - - - - - - G Q - Q 
- - - - - - - - - - - K G - M - 
G - - - - - - - - - - - G G G G 
- - - - G - - - - - - - G G G G 
- - G - - G - - - - - G - - G G 
- - - - - - - - G - - - - - G G 
G G G G - - - - G - - - - - G G 
- - - - - - - - G - - - - - G G 
- - - - - - - G - - - - - - - - 
- - - - - - G - - - - - - - - - 
G G - G - G G - - - - - G G G G 