- - - - - - - - - - - - - - - - 
- - - - - - - - - - - - - - - - 
- - - - - - - - - - - - - - - - 
- - - - - - - - - - - - - - - - 
- - - - - - - - - - - - - - - - 
- - - - - - - - - - - - - - - - 
- - - - - - - - - - - - - - - - 
- - - - - - - - - - - - - - - - 
- - - - - - - - - - - - - - - - 
- - - - - - - - - K - - - - - - 
- - - G - - - G - G - - - G - - 
G G G G G G G G G G G G G G G G 