G - - - - - - - - - - - - - - - 
G G - - - - - - - - - - - - - - 
G G G K - - - G - G - G - - - - 
G G G G G - - - - - - - - - - - 
G G G - - - - - - - - - G - - - 
G G - - - G G - - - - - G - - - 
G G - - - - - - - G G - G - - - 
G G - - - - - - - - - - G - - - 
G G - - - G G G - - - - G - - - 
- - Q - - - - - - - - - G - - - 
- - - - - - - - - - - - G M M - 
G G G G - - - - G - - - G G G G 