- - - - - - - - - - - - - - - - 
G - - - - - - - - - - - - - - - 
G - - - - - - - - - - - M - - - 
G K - G - G - G - G G G G - Q - 
G - - - - - - - - - - - - - - G 
G - - - - - - - - - - - - - G - 
G - - - - - - - - - - - - - - - 
G - - - - - G - - - - G G G G - 
G - - - - - - G - - - - - - - - 
- - - - G - G - - - - - - - - - 
- - - - - - - - - - - - - - - - 
G G - - G - - - G - - - G - - G 