- - - - - - - - - - - - - - G G 
- - - - - Q - - - - - - - - G G 
- - - - - - M - - - - - - - G G 
- K - - - G G - - - - - - - - G 
- - - - - - - - - - G - - - - G 
- G G - - - - - - G G G - - - G 
- - - - - - - - - - - - - - G - 
- - - - - - - - - - - - - G - - 
- - - - - - - - - - G - - - - - 
- - - G G - - G - - G G - - - - 
- - - G G - - G - - G - G - - - 
G G G G G - - G G - G - - G G G 