G - - - - G - - - - - G - - - - 
G G G - - G G - G - G G - - G G 
G G G - G - G - G - G - G - G G 
G G G G G G G G G G G G G G G G 
G G G G G G G G G G G G G G G G 
G G G G G G G G G G G G G G G G 
G G G G G G G G G G G G G G G G 
G G G G G G G G G G G G G G G G 
G G G G G G G G G G G G G G G G 
- - Q Q Q Q Q Q Q Q Q Q Q - - - 
- - - - - - - - - - - - - M M K 
G G G G G G G G G G G G G G G G 