G - - - - - - - - - - - - - - G 
G - - - Q - - - - - - Q - - - G 
G - - - - - - M - - - - - - - G 
G - - - G G G G G G G G - - - G 
G - - - - - - - G K - - - - - G 
G G - - - - - G - - - - - - G G 
G - - - - - - - G - - - - - - G 
G - - G - - - G - - - - G - - G 
G - - - - - - - G - - - - - - G 
- - - - - - - G - - - - - - - - 
- - - - - - - - G - - - - - - - 
G G G G G G G G G G G G G G G G 