- - - - - - - - - - - - - - - - 
- - - - - - - - - - - - - - - - 
- - - - - - K - - - - - - - - - 
- - - - - - - G - - - - - - - - 
G Q G - - - - G G G G - - - G G 
G - G - - - - - - - - - - - - G 
G M G - - - - - - - - - - - - G 
- G G G G G G - - - - G G - - G 
- - G G G G G G G - - G G G G G 
- - - - - - - - - - - - - - - - 
- - - - - - - - - - - - - - - - 
G G G G G G G G G G G G G G G G 