- - K - - - - - - - - - - - - - 
- - - - - - - - - - - - - - - - 
- - G G G G - - - G G G G - - - 
- - - - - G - - - - - - G - - - 
- - - - - G - - - - - - G - - - 
- - - - - G - - - - - - G - - - 
- - - G G G - - - - G G G - - - 
- - - G - G G - - - G - G G - - 
- - - G G G - G - - G G G - G - 
- - - - - - - - - - - Q Q Q - - 
- - - - - - - - - - - - - - M - 
G G G G G G G G G G G G G G G G 