- - - - - - - - - - - - - - - - 
- - - - - - - - - - - - - - - - 
- - - - - - - - - - - - - - - - 
- - - - - - - G - - G - - - - - 
- - - - - - G - - - - G - - - - 
- - - - - G - - - - - - G - - - 
G - - - G - - - - - - - - G - - 
G - - - G Q Q Q - - - - K G - - 
G G - - G - - - M M M M - G - - 
- - - - G G G G G G G G G G - - 
- - - G G G G G G G G G G G - - 
G G G G G G G G G G G G G G G G 