- - - - - - - - - - - - - - - - 
- - - - - - - - - - - - - - - - 
- - - - - - - - - - - - - - - - 
- - - - - - - - - - - - - - - - 
- - - - - - - - - - - - - - - - 
- - - - - - - - K - - - - - - - 
- - - - - - - G G - - - - - - - 
- - - - - - - - - - - Q Q - - - 
- - - - - - - - - - - - - - - - 
- - - - G - - G G - - G M - - - 
- - - G G - - - - - - G G - - - 
G G G G G - - - - - - G G G G G 