- - - - - - - - - - - - - - - - 
- - - - - - - - - - - - - - - - 
- - - - - - K - - - - - - - - - 
- - - - - - G - - - - - - - - - 
- - G - - - - - - - - - - - - - 
- G - G - - - - - - - - - - - - 
- - - - - - - G G - - - - - - - 
- - - - - - G - - - - - - - - - 
- - - - - G - - - - - - - - - - 
- - Q - G - - - - - - - - - - - 
- M - G - - - - - - - - - - - - 
G G G G G G G G G G G G G G G G 