G G G G G - - - G G G - - - - - 
- - - - - G - G - K G - - - - - 
- - - - - - G - - - G Q Q - - - 
- - - - - - - - - - G - - M - - 
- - - - - - - - - - G G G G - - 
- - - - - - - - - - - - - - - - 
- - - - - - G G - - - - - - - - 
- - - - - - - - - - - - - - - - 
G - - - G - G - - - - - - - - - 
- - - - - - - - - - - - - - - - 
- - - - - - - - - - - G - - - - 
G G G - - - - - - - - - - - G G 