G G G - - - - - G G G G G G G G 
G G - - - - - G - - - - - - - - 
G - - - - M G - - - - - - - - - 
G - - Q M G - - G G - - - - G - 
- - - - G - - - - - G - - - G - 
- - - G - - - - - - - - - G - - 
- - - G - - - - - - - - G G - - 
- - - - - - - - - - - G - G - - 
- - - - - G - - G - - - - - - - 
- - - - - - - - - - - G - - - K 
- - - - - - - - - - - - - - - - 
G G G G - - - - - - - - - - - G 