- - - - - - - - - - - - - - - - 
- - - - - - - - - - - - - - - - 
- - - - - - - - - - - - - - - - 
- - - - - - - - - - - - - - - - 
- - K - - - - - - - - - - - - - 
- - G - G - - - - - - - - - - - 
- - - - - G - - - - - - - - - - 
- - - - - - - - G G - - - - - - 
- - - - - - - G - - - - - - - - 
- - - - - G - - - - - - - - - - 
- - - G - - G - M - - - - - - - 
G G G G G G G G G - - - - G G G 