G - - - - - - - - - - - - - - G 
G - - - - - - - - - - - - - - - 
G - - - K - - - - - - - - - - - 
G - - - G - - - - - - - - - - - 
G - - - - - - - - - - - - - G G 
G - - - - - - - - - - - - - - G 
G - - - - - - - - - - - - - - G 
G - - - - - - - - - - - - - - G 
G - - - - - - - - - - - - - - G 
- - - - - - - - - - - Q Q Q Q G 
- - - - - - - - M M M - - - - G 
G G G G G G G G G G G G G G G G 