- - - - - - - - - - - - - - - -
- - - - - - - - - - - - - - - -
- - - - - - - - - - - - - - - -
- - - - - - - - - O - - - - - -
- - - - T T T T T T T T - - - -
- - - - T T T T T T T T - - - -
- - - - T T T T T T T T - - - -
- - - - T T T T T T T T - - - -
- - - - - - - - - - - - - - - -
- - - - - - - - - - - - - - - -
- - - - - - - - - - - - - - - -
- - - - - - - - - - - - - - - -