- - - - - - - - - - - - - - - -
- - - - - - - - - - - - - - - -
M - - - - - - - - - - - - - - -
M - C - - - - - - - - - - - - -
M M - - - - - - - - - - - - - -
M M - - - - - - - - - - - - - -
M M M - - - - - - - - - - - - -
M M M - - - - - - - - - - - - -
M M M M - - - - - - - - - - - -
M M M M - W - - - - - - - - - -
M M M M M - - - - - - - - - - -
M M M M M S - - - - - - - - - -