- - - T T T T T T T T T T - - -
- - - T T T T T T T T T T - - -
- - - T T - - - R - - T T - - -
- - - T T - - - - - - T T - - -
- - - - - - - - - - - - - - - -
- - - - - - - - - - - - - - - -
- - - - - - - - - - - - - - - -
- - - - - - - - - - - - - - - -
D - - - - - - - - - - - - - - -
D D - - - - - - - - - - - - - -
D D D - - - - - - - - - - - - -
D D D D - - - - - - - - - - - -