- - - - - - - - F - - - - - - -
- - - - - - - - F - - - - - - -
- - - - - - - - F - - - - - - -
F - - - - - - - - - - - - - - -
F - - - - - - - - - - - - - - -
- - - - - - - - F - - - - - - -
- - - - - - - - F P - - - - - -
- - - - - - - - F - - - - - - -
- - - - - - - - F - - - - - - -
- - - - - - - - F - - - - - - -
- - - - - - - - F - - - - - - -
- - - - - - - - F - - - - - - -