T T T T T T - - - - - - - - - -
- O T - - R - - - - - - - - - -
- - T - - - - - - - - - - - - -
- - T - - - - - - - - - - - - -
- - T - - - - - - - - - - - - -
- - T - - - - - - - - - - - - -
- - T - - - - - - - - - - - - -
- - T - - - - - - - - - - - - -
- - T - - - - - - - - - - - - -
- - - - - - - - - - - - - - - -
- - - - - - - - - - - - - - - -
- - - - - - - - - - - - - - - -