- - - - - - - - - - - - - - - -
U U U U U U U U U U U U U U U U
U U U U U U U U U U U U U U U U
- - - - - - - R - - S - - - - -
- - - - - - - - - - - - - - - -
- - - - - - - - - - - - - - - -
- - - - - - - - - - - - - - - -
- - - - - - - - - - - - - - - -
- - - - - - - - - - - - - - - -
- - - - - - - - - - - - - - - -
- - - - - - - - - - - - - - - -
- - - - - - - - - - - - - - - -