- - - - - - - - - - - - - - - -
- - - - - - - - - - - - - - - -
- - - - - - - - - - - - - - - -
- - - - - - - - - - - - - - - -
- - - - - - - - - - - - - - - -
- - - - - - - - - - - - - - - -
- - - - - - - - - - - - - - - -
- - - P - W - - - - - - O - - -
M M M M M M M M M M M M M M M M
M M M M M M M M M M M M M M M M
- - - - - - - - - - - - - - - -
- - - - - - - - - - - - - - - -