- - - - - - - - - - - - - - - -
- - - - - - - - - - - - - - - -
- - - - - - - - - - - - - - - -
- - - - - - - - - - - - - - - -
- - - - - - R - - O - - - - - -
- - - - - - - - - - - - - - - -
- - - - - - - - - - - - - - - -
- - - - - P - - - - - - - - - -
- - F F - - - - - - - - F F - -
- F F F F F F - - F F F F F F -
F F F F F F F F F F F F F F F F
F F F F F F F F F F F F F F F F