- - - - - - - - - - - - - - - -
- - - - - - - - - - - - - - - -
- - - - - - - - - - - - - - - -
- - P - O - - - - - - - - - - -
U U U U U U U U U - - U U U U U
U U U U U U U U U - - U U U U U
U U U U U U U U U U U U U U U U
- - - - - - - - - - - - - - - -
- - - - - - - - - - - - - - - -
- - - R - - - - - - - - - - - -
U U U U U U U U U U U U U U U U
- - - - - - - - - - - - - - - -