- - - - - - - - - - - - - - - -
- - - - - - - - - - - - - - - -
- - - - - - - - - - - - - - - -
- - - - - - - - - - - - - - - -
- - - - - - - - - - - - - - - -
- - - - - - - - - - - - - - - -
- - - - - - - - - - - - - - - -
- - - - - - - - - - - - - - - -
F F F F F F F F F F F F F F F F
- - - - - - - R - - - - - - - -
- - - - - - - - - - - - - - - -
- - - - - - - - - - - - - - - -