- - - - - - - D - - - - - - - -
- - - - - - - D - - - - - - - -
- - - - - - - D - - - - - - - -
- - - - - - - D - - - - - - - -
- - - - - - - D - - - - - - - -
- - - - - - - D - - - - - - - -
- - - - - - - D - - - - - - - -
- - - - - - O D - - - - - - - D
- - - - - - - D - - - - - - - D
- - - - - - - D - - - - - - - D
- - - - - - - D - - - - - - - -
- - - - - - - D - - - - - - - -