- - - - U - - - - - - - - - - -
- - - U O - - - - - - - - - - -
- - U - - - - - - - - - - - - -
- U - - - - - - - - - - - - - -
- U - P - - - - - - - - - - - -
- - U - - - - - - - - - - - - -
- - - U - - - - - - - - - - - -
- - R - U - - - - - - - - - - -
- - - - U - - - - - - - - - - -
- - - U - - - - - - - - - - - -
- - U - - - - - - - - - - - - -
- U - - - - - - - - - - - - - -